+-----------------------------+
/............      ............/
/.+-+.                    .+-+./
/./ /.                    ./ /./
/.+-+.                    .+-+./
/............................../
/.---.                    .---./
/.---.                    .---./
/.....                    ...../
+---+.                    .+---+
    /.                    ./   
    /.                    ./   
----+.                    .+----
     .                    .     
----+.                     +----
    /.                         /
    /.                         /
+---+.                         /
/    .                         /
/    .                         /
/.....                         /
/.                             /
/............................../
+-----------------------------+