+------------++------------+
/............//............/
/.+--+.+---+.//.+---+.+--+./
/./  /./   /.//./   /./  /./
/.+--+.+---+.++.+---+.+--+./
/........................../
/.+-+.++            ++.+-+./
/.+-+.//            //.+-+./
/.....//            //...../
+---+./+            +/.+---+
    /./+            +/./    
    /.//            //./    
----+.++            ++.+----
     .                .     
----+.++            ++.+----
    /.//            //./    
    /.//            //./    
+---+.++            ++.+---+
/.....                ...../
/.+-+.                .+-+./
/.++/.                ./++./
/. ++.                .++ ./
/........................../
+--------------------------+