+--------------------------+
/............//............/
/.+--+.+---+.//.+---+.+--+./
/./  /./   /.//./   /./  /./
/.+--+.+---+.++.+---+.+--+./
/........................../
/.+--+.++.+------+.++.+--+./
/.+--+.//.+------+.//.+--+./
/......//....//....//....../
+----+.//--+ ++ +--//.+----+
     /.//--+    +--//./     
     /.//          //./     
     /.//  +- --+  //./     
-----+.++  /    /  ++.+-----
      .    /    /    .            
-----+.++  +----+  ++.+-----
     /.//          //./     
     /.//  +----+  //./    
+----+.++  +----+  ++.+----+ 
/............//............/
/.+--+.+---+.++.+---+.+--+./
/.+-//.+---+....+---+.+--+./
/...
/-+
/-+  